000000000000000
100010001100101
111000100010001
100001111000111
110010000010001
101000001111001
100001100000011
111111111111111